9,9
111111111
100111001
101101101
111101111
110000011
111101111
101101101
100111001
111111111
3,3
4
0,0
0,8
8,0
8,8
